{ "Names" : {
    "1007" : "101",
    "1002" : "201",
    "1003" : "202",
    "1004" : "203",
    "1005" : "204",
    "1011" : "205",
    "1012" : "206",
    "1013" : "207",
    "1014" : "208",
    "1015" : "209",
    "1016" : "210",
    "1017" : "211",
    "1018" : "212",
    "1009" : "301",
    "1008" : "302",
    "1010" : "303",
    "1019" : "304",
    "1020" : "305",
    "1021" : "306",
    "1022" : "307",
    "1023" : "308",
    "1024" : "309",
    "1025" : "310",
    "1026" : "311",
    "1027" : "312",
    "1028" : "313",
    "1029" : "314",
    "1030" : "315",
    "1031" : "316",
    "1032" : "317",
    "1033" : "318",
    "1034" : "319",
    "1035" : "320",
    "1036" : "321",
    "1038" : "322",
    "1039" : "323",
    "902" : "103",
    "1001" : "102",
    "1037" : "1002",
    "1040" : "1004",
    "1041" : "1003",
    "1043" : "1005",
    "1048" : "213"

},

"SubNames" : {
    "SHOP_TYPE_ACTIVITY_ASTER" : ""

}
}